111111111111111111111111111111
1E0000000000000C00000C00000001
1P0001010010000010100100010101
101001001010101000100100010101
100000000C00C000000000000000C1
10000000000000C00000C000000011
111001010010000010100100010101
111001001010101000100100010101
111000000C00C000000000000000C1
111111111111111111111111111111