1111111111111
1C010000000C1
1000010001001
100011E000001
1001C000000C1
1000011111001
1C0011EP00001
1111111111111