11111111111111111111111111
10000C000000110000000000E1
100000001000C00000000000P1
10000000C00100000001111111
10000000000000000001
11111111111111111111